WWWWWWWWWWWWWWWWWOWWWWWWW
W   W       W W       W W
W W W WWWWWWW W WWWWW W W
W W W W     W   W   W W W
W WWW W WWW WWWWW W W W W
W   W   W   W     W     W
W W WWWWW WWW WWWWW WWW W
W W     W W   W   W W   W
W WWWWWWW W WWW WWW WWW W
W   W     W   W     W   W
WWW W WWW WWWWW WWWWW WWW
W       W W   W     W   W
W WWWWWWW W W WWWWWWW W W
W   W     W W       W W W
WWW WWW W W WWWWW W W W W
W W   W W W W     W W W W
W WWW WWW W W WWWWW W WWW
W   W W   W W W     W   W
W WWW W WWWWW W WWWWWWW W
W W   W W W   W W       W
W W WWW W W W W W W WWW W
W W W   W   W W   W   W W
W W W WWWWWWWWWWWWWWW W W
W   W                 W W
WWWWWWWWWWWWWIWWWWWWWWWWW

